NO ./parsing/assets/coin.xpm
SO ./parsing/assets/player.xpm
WE ./parsing/assets/wall.xpm
EA ./parsing/assets/floor.xpm

F 220,100,0
C 225,30,0

11111111
10000N01
11111111